{
  "grid": [
    " ^ ############### ### ^ #####  ",
    "#@#               #   ^ #     ^ ",
    "# # #  ######## ^ # ^   # ^ ^  #",
    "# # # #        ^   ^ ^  #  ^ # #",
    "#  ^  #  ##  ^        ^ #    # #",
    "#     # #  ^  # ###  ^   ####  #",
    "# ^ ##  # ^  ##    ^  ^        #",
    "#  ^ #  #  ^   ####  #  #  ^ ^ #",
    " #    ^ # ^ ^        #  # # ^ ^ ",
    " ### #  #  ^ ^ #########  #    #",
    "#    #  #                 # ^  #",
    "# # ^  # # # ############ #  ^ #",
    "# #  ^ #  # #            ^  ^  #",
    "# # ^          ^ ^ ^ ^    ^  ^ #",
    "# #  ####### ## ^ ^ ^ ^  ^  ^  #",
    "# #         ^          #  ^  # #",
    "# #  ^ ^ ^ ^   ^ ^ ^ ^ # ^ ^ # #",
    "#  ## ^ ^ ^ ^ # ^ ^ ^  #  ^  # #",
    "#             #     <^ # ^   # #",
    "# #### #######   ####  #  ^ ^  #",
    "#     ^         #      # ^   # #",
    " ###   #######  # ###  #  ## # #",
    "#   #         ^ #    # #     # #",
    "# # # ## ##  ^  # ^ ## # ^ ^ # #",
    "# # #   #  ^  ^  ^ ^  ^ ^ ^ ^  #",
    "# # # ^ # ^  #               ^ #",
    "#  ^ ^  #    ############ ###  #",
    "#B       ####                  #",
    "# ^ ^ ^ ^      ############### #",
    " ^ ^ ^ ^   ####                #",
    "^         ^     ^ ^ ^ ^ ^ ^ ^ ^ ",
    " ######### ##### ^ ^ ^ ^ ^ ^ ^  "
  ],
  "name": "Brushfire",
  "chips": 0,
  "timeLimit": 80,
  "blocks": [],
  "trapConnections": []
}
