{
  "grid": [
    "################################",
    "#+     ╬╬╬╬╬╬╬╬╬╬╬╬╬╬╬╬╬     -  ",
    "###############╬############### ",
    "#+     ~~~~~~~#╬#^^^^^^^     +# ",
    "#############~#╬#^############# ",
    "#############~#╬#^############# ",
    "#       #   #~#╬#^#           # ",
    "# #####↓# # #~#╬#^# ######### # ",
    "#   #   # # #~#╬#^#   #       # ",
    "### #↟r # # #~#╬#^### # #####↑# ",
    "#   #   # # #~#╬#^#   # #   → # ",
    "# ###↓### # #~#╬#^# ### # c☝#@# ",
    "# #       # #~#╬#^# # ← →   # # ",
    "# # ###↑### #~#╬#^# # ####### # ",
    "# # #   #   #~#╬#^# ← #   #   # ",
    "# # # #↓#↓###~#╬#^### # # # ### ",
    "#   # #   #FC     RI#   # #   # ",
    "# ### ### ###     #######↑### # ",
    "#↓#   → #   ←     →         # # ",
    "# # ### ###↓#↑#Y#↓### #####↑# # ",
    "# → # # #   # #S# #   #     # # ",
    "# # ### # ### ### # ### # ### # ",
    "# # →   #   →     #   ← #↓#   # ",
    "# ### ##### # ####### # # # ### ",
    "#   # # →   # #   ←   # # ← #<  ",
    "# # # # # ### # ####### # ######",
    "# # #   # # →    ←  #   #     ##",
    "#↓# ##### # ####### # ####### ##",
    "# #       #   #   # #       #↓##",
    "# #######↑### #by # #######↑# ##",
    "#          →  ░   ░   →       ##",
    "################################"
  ],
  "name": "Trinity",
  "chips": 3,
  "timeLimit": 300,
  "blocks": []
}
