{
  "grid": [
    "################################",
    "#╬╬╬╬╬╬╬╬╬╬╬╬╬╬╬╬╬╬╬╬╬╬╬╬╬╬╬╬╬╬#",
    "#╬╬╬╬╬╬╬╬╬╬╬╬╬╬╬╬╬╬╬╬╬╬╬╬╬╬╬╬╬╬#",
    "#╬╬╬╬╬╬╬╬╬╬╬╬╬╬╬╬╬╬╬╬╬╬╬╬╬╬╬╬╬╬#",
    "#╬╬╬╬╬╬╬╬╬╬╬╬╬╬╬╬╬╬╬╬╬╬╬╬╬╬╬╬╬╬#",
    "#╬╬╬╬╬╬╬╬╬╬╬╔╬╬╬╬╬╬╬╬╬╬╬╗╬╬╬╬╬╬#",
    "#╬╬╬╬╬╬╬╬╬╬╬╬╬╬╬ ╬╬╬╔╬╬╬╬╗╬╬╬╬╬#",
    "#╬╬╬╬╬╬╬╬╬╬╔╬╬╬╬╬╬╬╬╬╬╬╬╬╝╬╬╬╬╬#",
    "#╬╬╬╬╬╬╬╬╬╬╚╬╬╬╬╬╬╬╬╬╬╬╬╬╗╬╬╬╬╬#",
    "#╬╬╬╬╬╬╬╬╬╬╔╬╬╬╬╗╔╬╗╬╔╬╬╬╝╬╬╬╬╬#",
    "#╬╬╬╬╔╬╗╬╬ ╬╬ ╔╬╬╬╗╬╬╚╬╬╬╗╬╬╬╬╬#",
    "#╬╬╬╬╬╔╬╬╬╬╬ ╗╬╔╬╬ ╬╬╬╬╗╬╬╬╬╬╬╬#",
    "#╬╬╬╬╚╬╬╬╬╗╬╬╬╬╚╬╬╬╬╬╬╬╝╬╚╬╗╬╬╬#",
    "#╬╬╬╬╬╬╚╝╬╬╚╬╬╬╗╬<╬╚╝ ╬╬╚╗╬╬╬╬╬#",
    "#╬╬╬╬╔╬╬╗╔ ╗╬╬╚ ╬╬ ╬╬╬╬╗╔╬╗╬╬╬╬#",
    "#╬╬╬╬╚ ╗╬╬╬╬╬╬╬╚╝╔╬╬╗╔╗╬╚↓╝╬╬╬╬#",
    "#╬╬╬╬╬#╬╬╬╬╬╬╬╬╬╔╬╝╔╬←╬╬╬╝╬╬╬╬╬#",
    "#╬╬╬╬╔╗╬╬╚╬╬╝╬╔╬╬╬╗╬╬╚╝╬╔╬╬╝╬╬╬#",
    "#╬╬╬╬→╬╬╝╬╬╬╬╚╬╬╝╬╬╚ ╬╬╬╬╗╬╬╬╬╬#",
    "#╬╬╬╬╚╝╬╔╗╬╬╔╬╬╬╬╝╚╗╚╬╬╝╬╬╬╬╬╬╬#",
    "#╬╬╬╬╬╬╬╬╬╬╬╬ ╬╬╔╬╬╬╬╗╬╬╬╬╬╬╬╬╬#",
    "#╬╬╬╬╬╬╬╬╬╬╚╬╬╬╬╬╬╬╬╬╬╬╗╚╬╗╬╬╬╬#",
    "#╬╬╬╬╔╬╬╝╬╬╬╬╔╬╬╬╬╬╬╬╬╬╬╬╬╝╬╬╬╬#",
    "#╬╬╬╬╬╔╬╬ ╝╬╬╬╬╔╬╗╔ ╗╬╔ ╗╬╬╬╬╬╬#",
    "#╬╬╬╬╬╬╬╔╝╔╗╬╬╬╚↑╝╚?╝╬╬#╬╬╬╬╬╬╬#",
    "#╬╬╬╬╬╬╬╚╬╝╚╬╝╚╬╬╬╬@╬╝╚╬╝╬ ╬╬╬╬#",
    "#╬╬╬╬╚→→╬╬╬╬→╬╬╬╝╬╬╚╬╬╬╬╬╝╬╬╬╬╬#",
    "#╬╬╬╬╬╬╬╬╬╬╬╬╬╬╬╬╬╬╬╬╬╬╬╬╬╬╬╬╬╬#",
    "#╬╬╬╬╬╬╬╬╬╬╬╬╬╬╬╬╬╬╬╬╬╬╬╬╬╬╬╬╬╬#",
    "#╬╬╬╬╬╬╬╬╬╬╬╬╬╬╬╬╬╬╬╬╬╬╬╬╬╬╬╬╬╬#",
    "#╬╬╬╬╬╬╬╬╬╬╬╬╬╬╬╬╬╬╬╬╬╬╬╬╬╬╬╬╬╬#",
    "################################"
  ],
  "name": "South Pole",
  "chips": 0,
  "hint": "What was the name of this level?",
  "blocks": []
}
