{
  "grid": [
    "################################",
    "#t#↓←←←##↓←←#+##^^^^####^^^#^#r#",
    "#↓#↓##↑←←←#↑#^^^^##^^^^^^#^#^^^#",
    "#↓#↓#######↑########^###^#^###^#",
    "#↓#→→→→→→↓#↑←←+#↓←r#^^^#^#^^^^^#",
    "#↓#↑#####↓######↓#####^#^####^##",
    "#↓#↑←←←#↓←←←←←←←←#+^^^^#^^^^#^^#",
    "#↓####↑#↓#######+##########^##^#",
    "#↓#→→→↑#→→→→→→↓###^^^^^^^^^^#^^#",
    "#↓#↑##########↓#:#^##########^##",
    "#↓#↑#        #↓#-#^#        #^##",
    "#↓#↑# U ####C#C#C#C#C#### I #^^#",
    "#↓#↑#   * r#         #r *   ##^#",
    "#↓#↑########r   @ 0 c#########^#",
    "#→→↑#   * c#         #c *   #^^#",
    "###↑# F ####R#R# #R#R#### S #^##",
    "#+#↑#        #~#;#╬#        #^##",
    "#↓#↑##########~#<#╬##########^+#",
    "#↓#↑←←#~~~~~~~~###╚╬╬╬╬╬╬╬╬╗####",
    "#↓###↑#~########+##########╬#╔╬#",
    "#→→→→↑#~~~~~~~~#╬#c╬╬╗#╔╬╬╬╝#╬##",
    "#######~######~#╬####╬#╬#####╬##",
    "#~~~~~~~#~~~~~~#╚╬╬╗#╬#╬╬╬╬╬╬╬╗#",
    "#~#######~#~#######╬#╬#╬######╬#",
    "#~#~~~#~~~#~~~#~~~#╬#╬#╚╬╬╬╬╗#╬#",
    "#~#~#~#~#####~~~#+#╬#╬####╬#╬#+#",
    "#~###~#~~~~~#######╬#╚╬╬╬╬╝#╬###",
    "#~~~~~#####~#+##╔╬╬╬########╬╬╗#",
    "#~###~#c~~~~#╚╬╬╝##╚╬╬╬╗#t╬╬╝#╬#",
    "#~#+#~#####~###########╬######╬#",
    "#~~~#~~~~~~~~~~~~~~~~+#╚╬╬╬╬╬╬╝#",
    "################################"
  ],
  "name": "Elementary",
  "chips": 12,
  "timeLimit": 250,
  "blocks": [
    {
      "x": 6,
      "y": 11
    },
    {
      "x": 6,
      "y": 15
    },
    {
      "x": 26,
      "y": 11
    },
    {
      "x": 26,
      "y": 15
    }
  ],
  "trapConnections": [
    {
      "button": {
        "x": 16,
        "y": 9
      },
      "trap": {
        "x": 16,
        "y": 16
      }
    }
  ]
}
