{
  "grid": [
    "################################",
    "#<-/     [[[[[[[[[[[[[[     /-<#",
    "#--     [[            [[     --#",
    "#/     [                [     /#",
    "#     [                  [     #",
    "#    [                    [    #",
    "#   [                      [   #",
    "#  [                        [  #",
    "# [       ++        ++       [ #",
    "#[[       ++        ++       [[#",
    "#[        ++        ++        [#",
    "#[            =               [#",
    "#.                    =       .#",
    "#.      =                     .#",
    "#.             @   =          .#",
    "#.               =            .#",
    "#.         =                  .#",
    "#.   +         =          +   .#",
    "#.   ++            =     ++   .#",
    "#.    ++   =            ++    .#",
    "#[     ++              ++     [#",
    "#[      +++          +++      [#",
    "#[[       +++      +++       [[#",
    "# [         ++++++++         [ #",
    "#  [                        [  #",
    "#   [                      [   #",
    "#    [                    [    #",
    "#     [                  [     #",
    "#/     [                [     /#",
    "#--     [[            [[     --#",
    "#<-/     [[[[[[[[[[[[[[     /-<#",
    "################################"
  ],
  "name": "Nice Day",
  "chips": 46,
  "timeLimit": 100,
  "blocks": []
}
