{
  "grid": [
    "################################",
    "#    #              #     # F  #",
    "# ## # #   #######  # 0## # ## #",
    "#   0  #         #      # #  # #",
    "## ### # ### #0# ## ### # ##   #",
    "## #   # #   # # #        0  # #",
    "## # # # #   # # #    #0# #  # #",
    "#  0 # # ##  # #          #  # #",
    "## #    0 #       ##############",
    "#      #  #0    ###*         ###",
    "#   #     #  ####              |",
    "### #######  #*       ~~~~~~  #|",
    "# 0 #    #   #*    ~~~~^~~~~~~#|",
    "#     # 0#  ###   ~~~~~~~~~~~~#|",
    "# ### #    ##    ~~~~~~~~~~~  #|",
    "#  #  # ####    ~~~~^~~~~~    #|",
    "#  #  0  #*    ~~~^~~~~       #|",
    "#  ###   #*   ~~^~~~~         #|",
    "##  ##  ###  ~~~~~~~          #|",
    "#   ##  #   ~~~^~~~     % % % #|",
    "# #  # ##   ~~^~~~      %%%%% #|",
    "# 0     ## |~~~~~~       %%%  #|",
    "# ## ##  # |~~^~~~ % % % %%%  #|",
    "#  # ### # |~~~~~~ %%%%%%%%%  #|",
    "#      0 # |~~^~~  %%%%<%%%%  #|",
    "#  ####  # ~~^~~~  % %---% %  #|",
    "#  #  #### ~^~~~~  % %---% %  #|",
    "#    0   # ~~~~~~  %%%---%%%  #|",
    "#  #       ~^~~~~  %%%---%%%  #|",
    "#  ######  ~~^~~~             #|",
    "#### @ ########################|",
    "####____________________________"
  ],
  "name": "Castle Moat",
  "chips": 0,
  "timeLimit": 600,
  "blocks": [
    {
      "x": 28,
      "y": 1
    }
  ]
}
