{
  "grid": [
    "################################",
    "#≈≈≈≈≈≈≈≈≈≈≈≈≈≈≈≈≈≈≈≈≈≈≈≈≈≈≈≈≈≈#",
    "#≈≈@≈≈≈≈≈≈≈≈≈≈≈≈≈≈≈≈≈≈≈≈≈≈≈≈≈≈≈#",
    "#≈≈+≈≈≈≈≈≈≈≈≈≈≈≈≈≈≈≈≈≈≈≈≈≈≈≈≈≈≈#",
    "#≈≈+≈++++++++++++++++++++≈≈≈≈≈≈#",
    "#≈≈+≈+≈≈≈≈≈+≈≈≈≈+≈≈≈≈≈≈≈+≈≈≈≈≈≈#",
    "#≈≈+≈+≈≈≈≈≈+≈≈≈≈+≈≈≈≈≈≈≈+≈≈≈≈≈≈#",
    "#≈≈+≈+≈≈≈≈≈+≈≈≈≈+≈≈≈≈≈≈≈+≈≈≈≈≈≈#",
    "#≈≈+≈⇈ ≈≈≈≈+≈≈≈≈+≈≈≈≈≈≈≈+≈≈≈≈≈≈#",
    "#≈≈+≈  ≈ ≈≈+≈≈≈≈+≈≈≈≈≈≈≈+≈≈≈≈≈≈#",
    "#≈≈+≈  ≈ ≈≈+≈≈≈   ≈≈ ≈≈≈+≈≈≈≈≈≈#",
    "#≈≈+≈    ≈≈+≈≈≈ ⇈    ≈≈≈+≈≈≈  ≈#",
    "#≈≈+≈≈≈≈≈≈≈+≈≈≈≈≈≈≈≈≈≈≈≈+≈≈≈≈ ≈#",
    "#≈≈++++++++++++++++≈≈≈≈≈+≈≈≈≈ ≈#",
    "#≈≈≈≈≈≈≈≈≈≈---≈≈≈≈+≈≈≈≈       ≈#",
    "#≈≈≈≈≈≈≈≈≈≈-<-≈≈≈≈+≈≈≈≈    ≈≈≈≈#",
    "#≈    ≈≈≈≈≈---≈≈≈≈+≈≈≈≈ ⇈  ≈   #",
    "#  ≈≈ ≈≈≈++++++ ⇈≈+≈≈≈≈≈≈≈≈≈   #",
    "#  ≈≈≈≈≈≈+≈≈≈≈≈  ≈++++++++++ ⇈ #",
    "#⇈ +++++++≈≈≈≈   ≈+≈≈≈≈≈≈≈≈≈   #",
    "#  ≈≈≈≈≈≈+≈≈≈≈≈≈≈≈+≈≈≈≈≈≈≈≈≈   #",
    "#≈≈  ≈≈≈≈+≈≈≈≈≈≈≈≈+≈≈≈≈≈≈≈     #",
    "#≈≈ ⇈++++++++++++++≈≈≈≈≈≈≈≈≈≈≈≈#",
    "#≈≈  ≈≈≈≈≈≈≈≈≈≈≈≈≈+≈≈≈≈≈≈≈≈≈≈≈≈#",
    "#≈≈≈  ≈≈≈≈≈≈ ⇈  ≈≈+≈≈≈≈≈≈≈≈≈≈≈≈#",
    "#≈≈≈≈≈≈≈≈≈≈≈  ≈ ≈≈+++++++++⇈≈≈≈#",
    "#≈≈≈≈≈≈≈≈≈≈≈≈+≈≈≈≈+≈≈≈≈≈≈≈≈ ≈≈≈#",
    "#≈≈≈≈++++++++++++++≈≈≈≈≈≈   ≈≈≈#",
    "#≈≈≈≈+≈≈≈≈≈≈≈≈≈≈≈≈≈≈≈≈≈ ≈ ≈≈≈≈≈#",
    "#≈≈≈≈ ≈≈ ≈≈≈≈≈≈≈≈≈≈≈≈≈≈   ≈≈≈≈≈#",
    "#≈≈≈≈⇈   ≈≈≈≈≈≈≈≈≈≈≈≈≈≈≈≈≈≈≈≈≈≈#",
    "################################"
  ],
  "name": "Digger",
  "chips": 146,
  "timeLimit": 210,
  "blocks": []
}
