{
  "grid": [
    "                                ",
    "                                ",
    "                                ",
    "                                ",
    "                                ",
    "                                ",
    "                                ",
    "         #######                ",
    "         #  +  #                ",
    "         #     #                ",
    "         #  #  ##########       ",
    "       ###  #b  ~~     +#       ",
    "       #<-  ##b ~~ 00@? #       ",
    "       ###  #b  ~~     +#       ",
    "         #  #  ##########       ",
    "         #     #                ",
    "         #  +  #                ",
    "         #######                ",
    "                                ",
    "                                ",
    "                                ",
    "                                ",
    "                                ",
    "                                ",
    "                                ",
    "                                ",
    "                                ",
    "                                ",
    "                                ",
    "                                ",
    "                                ",
    "                                "
  ],
  "hint": "Push blocks into water to make dirt. Watch out for monsters.",
  "name": "LESSON 2",
  "chips": 4,
  "timeLimit": 100,
  "blocks": []
}
