{
  "grid": [
    "################################",
    "###    →→→→         ############",
    "### ########## ^^^^ ############",
    "### R_ ####### ^++^ ############",
    "#####o ####### ^++^ ############",
    "#   ## ####### ^^^^   ######## #",
    "# # #  # #####      ########## #",
    "#   ## # ##################### #",
    "# #r#  # ##################### #",
    "# #### # #####################I#",
    "#  ##  # #######################",
    "##  ## #########################",
    "## ##  #########################",
    "## #   #########################",
    "################################",
    "################################",
    "################################",
    "################################",
    "################################",
    "################################",
    "################################",
    "################################",
    "################################",
    "################################",
    "################################",
    "################################",
    "################################",
    "################################",
    "################################",
    "################################",
    "################################",
    "################################"
  ],
  "name": "Tossed Salad",
  "chips": 15,
  "timeLimit": 400,
  "blocks": [],
  "trapConnections": []
}
