{
  "grid": [
    "                                ",
    "             ###                ",
    "             #<#                ",
    "         #####-####             ",
    "         #↓←←←←←←←#             ",
    "         #↓######↑#             ",
    "      ####↓#~~~~#↑####          ",
    "      #↓←←←#~S+~#↑←←←#          ",
    "      #↓####~~~~####↑#          ",
    "      #↓#╔╬╬    ^^^#↑#          ",
    "      #↓#╬I#    ^U^#↑#          ",
    "      #↓#╬+# @? ^+^#↑#          ",
    "      #↓#╚╬╬  F ^^^#↑#          ",
    "      #↓####    ####↑#          ",
    "      #→→→→→↑↑↑→→→→→↑#          ",
    "      ######↑+↑↑######          ",
    "           #↑↑↑↑#               ",
    "           ######               ",
    "                                ",
    "                                ",
    "                                ",
    "                                ",
    "                                ",
    "                                ",
    "                                ",
    "                                ",
    "                                ",
    "                                ",
    "                                ",
    "                                ",
    "                                ",
    "                                "
  ],
  "hint": "Suction-boots for force floors. Fire boots for fire. Flippers for water. Skates for ice.",
  "name": "LESSON 3",
  "chipsLeft": 4,
  "timeLimit": 100,
  "blocks": [],
  "trapConnections": [],
  "extraChips": []
}
