{
  "grid": [
    "                                ",
    "                                ",
    "                                ",
    "                                ",
    "          ###########           ",
    "          #<*       #           ",
    "          ###  ***  #           ",
    "            #    *  #           ",
    "            #  ***  #           ",
    "            #  ***  #           ",
    "            #    *  #           ",
    "            #  ***  #           ",
    "            ##R########         ",
    "            #   .     #         ",
    "            # ##### # #         ",
    "            #   [=  # #         ",
    "            ######### #         ",
    "            #~r^      #         ",
    "            #~ ^  ⇠ ? #         ",
    "            #~ ^    @ #         ",
    "            #         #         ",
    "            ###########         ",
    "                                ",
    "                                ",
    "                                ",
    "                                ",
    "                                ",
    "                                ",
    "                                ",
    "                                ",
    "                                ",
    "                                "
  ],
  "hint": "The red button controls the clone machine. The brown button opens traps.",
  "name": "LESSON 5",
  "chips": 0,
  "timeLimit": 100,
  "blocks": []
}
