{
  "grid": [
    "                                ",
    "                                ",
    "                                ",
    "                                ",
    "                                ",
    "                                ",
    "            ##############      ",
    "            #↓←←←←←←←←←←←#      ",
    "         ####↓##########↑#      ",
    "         #→→→↓←←←←←←←←←#↑#      ",
    "         #↑##t########↑#↑#      ",
    "         #↑#    #  O ^↑#↑#      ",
    "         #↑# @? #F # ^↑#↑#      ",
    "         #↑#    #  # ^↑#↑#      ",
    "         #↑#   o#o # ^↑#↑#      ",
    "         #↑#############↑#      ",
    "         #↑~ # o#o __#→→↑#      ",
    "         #↑~ #  #  -<#↑###      ",
    "         #↑~ # I#t####↑#        ",
    "         #↑~ O  #   + ↑#        ",
    "         ###############        ",
    "                                ",
    "                                ",
    "                                ",
    "                                ",
    "                                ",
    "                                ",
    "                                ",
    "                                ",
    "                                ",
    "                                ",
    "                                "
  ],
  "hint": "Teleports can be directional. The thief takes your tools. New walls can appear under you.",
  "name": "LESSON 7",
  "chipsLeft": 3,
  "timeLimit": 150,
  "blocks": [],
  "trapConnections": [],
  "extraChips": [
    {
      "x": 11,
      "y": 9
    },
    {
      "x": 15,
      "y": 9
    }
  ]
}
