{
  "grid": [
    "################################",
    "###░░░░░░░░░░░░############<####",
    "###░  b  b  b ░############ ####",
    "###░b+░░░░░░░░░########### ;   #",
    "#  ░   b  b b ░ -            ↟ #",
    "# #░########+b░###########  :  #",
    "# #░ b  b  b  ░╬╗##╔╬╬╬╗##  0  #",
    "# #░░░░░░░░░░░░#╬##╬###╬##     #",
    "# ##### ########╬##╬#c#╬########",
    "# ##### ##+#####╚╬╬╝# #╚╬╬╬╬╬╗##",
    "# ##### ## ########## #######╬##",
    "# ###   #   ###      ↞      #╬##",
    "# ### ### # ### ##### ##### #╬##",
    "# ###  0 0  ### #yC]   ]Gr# #╬##",
    "# #   0 0   # #↡##### #####↟#╬##",
    "# # # ####### # #gY[   [R╬╬╬╬╝##",
    "# #   **** **+# ##### ##### ####",
    "# ########  + #      ↠      ####",
    "#     ##+  ** ####### ##########",
    "# %%% ##########r####.##########",
    "# %+% ##########~####↑##########",
    "# %'% ##########~#### ##########",
    "#     # ↓#######~###^╬^^^^^^^^^#",
    "####### ↓↓######~# R╬╬╬╬╬╬╬╬ ╬^#",
    "#@   +Y ↓↓↓#       #^╬╬ ╬╬╬ ╬╬^#",
    "### ### ↓↓↓%   0 ###^╬ ╬ ╬╬╬╬╬^#",
    "# ↠   # ↓↓↓%  0  ###^╬╬ ╬╬+╬╬ ^#",
    "#     # ↓↓↓' 0 0 ###^ ╬╬╬ ╬╬╬╬^#",
    "#  y  #↑←←←%     ###^╬ ╬╬╬╬ ╬╬^#",
    "#     ##############^╬╬╬ ╬╬╬ ╬^#",
    "#   ↞ ##############^╬╬╬╬ ╬╬╬ ^#",
    "####################^^^^^^^^^^^#"
  ],
  "name": "Nuts and Bolts",
  "chips": 9,
  "timeLimit": 400,
  "blocks": [
    {
      "x": 13,
      "y": 16
    }
  ],
  "trapConnections": [
    {
      "button": {
        "x": 28,
        "y": 5
      },
      "trap": {
        "x": 27,
        "y": 3
      }
    }
  ]
}
