{
  "grid": [
    "################################",
    "###░░░░░░░░░░░░############<####",
    "###░  b  b  b ░############ ####",
    "###░b+░░░░░░░░░########### ;   #",
    "#  ░   b  b b ░ -            ↟ #",
    "# #░########+b░###########  :  #",
    "# #░ b  b  b  ░╬╗##╔╬╬╬╗##     #",
    "# #░░░░░░░░░░░░#╬##╬###╬##     #",
    "# ##### ########╬##╬#c#╬########",
    "# ##### ##+#####╚╬╬╝# #╚╬╬╬╬╬╗##",
    "# ##### ## ########## #######╬##",
    "# ###   #   ###      ↞      #╬##",
    "# ### ### # ### ##### ##### #╬##",
    "# ###       ### #yC]   ]Gr# #╬##",
    "# #         # #↡##### #####↟#╬##",
    "# # # ####### # #gY[   [R╬╬╬╬╝##",
    "# #   **** **+# ##### ##### ####",
    "# ########  + #      ↠      ####",
    "#     ##+  ** ####### ##########",
    "# %%% ##########r####.##########",
    "# %+% ##########~####↑##########",
    "# %'% ##########~#### ##########",
    "#     #@↓#######~###^╬^^^^^^^^^#",
    "####### ↓↓######~# R╬╬╬╬╬╬╬╬ ╬^#",
    "#    +Y ↓↓↓#       #^╬╬ ╬╬╬ ╬╬^#",
    "### ### ↓↓↓%     ###^╬ ╬ ╬╬╬╬╬^#",
    "# ↠   # ↓↓↓%     ###^╬╬ ╬╬+╬╬ ^#",
    "#     # ↓↓↓'     ###^ ╬╬╬ ╬╬╬╬^#",
    "#  y  #↑←←←%     ###^╬ ╬╬╬╬ ╬╬^#",
    "#     ##############^╬╬╬ ╬╬╬ ╬^#",
    "#   ↞ ##############^╬╬╬╬ ╬╬╬ ^#",
    "####################^^^^^^^^^^^#"
  ],
  "name": "Nuts and Bolts",
  "chips": 9,
  "timeLimit": 400,
  "blocks": [
    {
      "x": 15,
      "y": 25
    },
    {
      "x": 14,
      "y": 26
    },
    {
      "x": 13,
      "y": 27
    },
    {
      "x": 15,
      "y": 27
    },
    {
      "x": 6,
      "y": 14
    },
    {
      "x": 7,
      "y": 13
    },
    {
      "x": 8,
      "y": 14
    },
    {
      "x": 9,
      "y": 13
    },
    {
      "x": 13,
      "y": 16
    },
    {
      "x": 28,
      "y": 6
    }
  ],
  "trapConnections": [
    {
      "button": {
        "x": 28,
        "y": 5
      },
      "trap": {
        "x": 27,
        "y": 3
      }
    }
  ]
}
