{
  "grid": [
    "################################",
    "#++++++++++++++++++++++++++++++#",
    "#++++++++++++++++++++++++++++++#",
    "#++++++++++++++++++++++++++++++#",
    "#++++#+++++++######+++++++#++++#",
    "#+++##++++++++++++++++++++##+++#",
    "#++++++++++++++++++++++++++++++#",
    "#++++++++++++++++++++++++++++++#",
    "#+++++++       @        +++++++#",
    "#+++++++ ++++++++++++++ +++++++#",
    "#+++++++ ++++++++++++++ +++++++#",
    "#+++++++ ++++++++++++++ +++++++#",
    "#+++++++ ++++++++++++++ +++++++#",
    "#+++#+++ ++++++++++++++ +++#+++#",
    "#+++#+++ +++++#--#+++++ +++#+++#",
    "#+++#+++ +++++#<<#+++++ +++#+++#",
    "#+++#+++ +++++#<<#+++++ +++#+++#",
    "#+++#+++ +++++#--#+++++ +++#+++#",
    "#+++#+++ ++++++++++++++ +++#+++#",
    "#+++++++ ++++++++++++++ +++++++#",
    "#+++++++ ++++++++++++++ +++++++#",
    "#+++++++ ++++++++++++++ +++++++#",
    "#+++++++ ++++++++++++++ +++++++#",
    "#+++++++       ⇈⇈       +++++++#",
    "#++++++++++++++++++++++++++++++#",
    "#++++++++++++++++++++++++++++++#",
    "#+++##++++++++++++++++++++##+++#",
    "#++++#+++++++######+++++++#++++#",
    "#++++++++++++++++++++++++++++++#",
    "#++++++++++++++++++++++++++++++#",
    "#++++++++++++++++++++++++++++++#",
    "################################"
  ],
  "name": "Hunt",
  "chips": 652,
  "timeLimit": 400,
  "blocks": []
}
