{
  "grid": [
    "################################",
    "#                              #",
    "#                              #",
    "#                              #",
    "#        ###                   #",
    "#        #+#                   #",
    "#  #######~#                   #",
    "#  #+~~  #~#                   #",
    "#  ####    #    #############  #",
    "#    #  o  #    #r  #   #  r#  #",
    "#    #    ####  # 0 # 0   0 #  #",
    "#    #~#  ~~+#  #   #   #   #  #",
    "#    #~#######  ## ###R######  #",
    "#    #+#        #   #   #   #  #",
    "#    ###        # 0 R o R 0 #  #",
    "#               #   #   #   #  #",
    "#               ######R### ##  #",
    "#      #####    #   #   #   #  #",
    "#      #  @#    # 0   0 # 0 #  #",
    "#      #ro #    #r  #   #   #  #",
    "#      #   #    #############  #",
    "#      ##-##                   #",
    "#       #<#                    #",
    "#       ###                    #",
    "#                              #",
    "#                              #",
    "#                              #",
    "#                              #",
    "#                              #",
    "#                              #",
    "#                              #",
    "################################"
  ],
  "name": "Teleblock",
  "chips": 4,
  "timeLimit": 250,
  "blocks": []
}
