{
  "grid": [
    "                                ",
    "                                ",
    "                                ",
    "                                ",
    "                                ",
    "                                ",
    "            ##############      ",
    "            #↓←←←←←←←←←←←#      ",
    "         ####↓##########↑#      ",
    "         #→+→↓←+←←←←←←←#↑#      ",
    "         #↑##t########↑#↑#      ",
    "         #↑#    #  O ^↑#↑#      ",
    "         #↑# @? #F # ^↑#↑#      ",
    "         #↑#    #  # ^↑#↑#      ",
    "         #↑#   o#o # ^↑#↑#      ",
    "         #↑#############↑#      ",
    "         #↑~ # o#o __#→→↑#      ",
    "         #↑~ #  #  -<#↑###      ",
    "         #↑~ # I#t####↑#        ",
    "         #↑~ O  #   + ↑#        ",
    "         ###############        ",
    "                                ",
    "                                ",
    "                                ",
    "                                ",
    "                                ",
    "                                ",
    "                                ",
    "                                ",
    "                                ",
    "                                ",
    "                                "
  ],
  "hint": "Teleports can be directional. The thief takes your tools. New walls can appear under you.",
  "name": "LESSON 7",
  "chips": 3,
  "timeLimit": 150,
  "blocks": []
}
