{
  "grid": [
    "                                ",
    "                                ",
    "                                ",
    "                                ",
    "                                ",
    "#####################           ",
    "#####################           ",
    "##░░░░░░░░░░░░░░░░░##           ",
    "##░░≈≈≈≈≈≈≈≈≈≈≈≈≈░░##           ",
    "##░░≈≈≈≈≈≈≈≈≈≈≈≈≈░░##           ",
    "##░░≈≈         ≈≈░░##           ",
    "##░░≈≈         ≈≈░░##           ",
    "##░░≈≈         ≈≈░░##           ",
    "##?░≈≈         ≈≈░░##           ",
    "#@░░≈≈   ⇈+    ≈≈░░-<           ",
    "##░░≈≈         ≈≈░░##           ",
    "##░░≈≈         ≈≈░░##           ",
    "##░░≈≈         ≈≈░░##           ",
    "##░░≈≈         ≈≈░░##           ",
    "##░░≈≈≈≈≈≈≈≈≈≈≈≈≈░░##           ",
    "##░░≈≈≈≈≈≈≈≈≈≈≈≈≈░░##           ",
    "##░░░░░░░░░░░░░░░░░##           ",
    "#####################           ",
    "#####################           ",
    "                                ",
    "                                ",
    "                                ",
    "                                ",
    "                                ",
    "                                ",
    "                                ",
    "                                "
  ],
  "hint": "Monsters are stopped by dirt and gravel.",
  "name": "LESSON 8",
  "chips": 1,
  "timeLimit": 100,
  "blocks": []
}
